1111111111111111
100C10C0C0C0C011
1000C01111100011
10P00011E0C00011
1000C01111100011
1111111111111111
