11111111111111
10C10C0C0C0C11
100C0111110011
10P011E0C00011
11111111111111
